R  45896398456945 4659824569457698

NO ./textures/greystone.xpm

SO      ./textures/bluestone.xpm
S                 ./textures/barrel.xpm
WE ./textures/eagle.xpm
EA    ./textures/colorstone.xpm
F 20, 224, 41
C 64, 132, 23

111 111
101 101
1011101
1000001
1000001            1111111111111111111111111111111111111
10000011111111111111222222222222222222222222222222222221
10000000000000000000222222222222222222222222222222222221
11111111110000011111222222222222222222222222222222222221
         1000001   1222222222222222222222222222222222221
         1000001   1222222222222222222222222222222222221
         1000001   1222222222222222222222222222222222221
         1000001   1222222222222222222222222222222222221
         1000001   1000000000000000000000000000000000001
         1000001   1000000000000000000000000000000000001
         1000001   1000000000000000000000000000000000001
         1000021   1000000000000000000000000000000000001
         1000001   10000000000000000000N0000000000000001
         1000001   1000000000000000000000000000000000001
         1000001   1111111111111110111111111111111111111
1111111111000001                 101
1000000000000001        111111111101
1000000000000001        100000000001
1000000000000001        101111111111
1000000000000001        101
1000000011111111        101
100000001   1111111     101
100000001   100000111111101
100000001   100000000000001
100000001   100000111111111
1000000011111000001
1000000000000000001
1000000000000000001
1111111111111111111